广东卫视: 广东卫视
广东珠江: 广东珠江
广东新闻: 广东新闻
广东民生: 广东民生
广东体育: 广东体育
经济科教: 经济科教
大湾区卫视: 大湾区卫视
广东影视: 广东影视
广东少儿: 广东少儿
嘉佳卡通: 嘉佳卡通
南方购物-精选: 南方购物-精选
广东移动: 广东移动
南方购物: 南方购物
岭南戏曲: 岭南戏曲
现代教育: 现代教育
广州综合: 广州综合
广州新闻: 广州新闻
广州法治: 广州法治
深圳卫视: 深圳卫视
深圳都市: 深圳都市
深圳体育: 深圳体育
深圳电视剧: 深圳电视剧
深圳财经: 深圳财经
深圳少儿: 深圳少儿
深圳宝安: 深圳宝安
深圳龙岗: 深圳龙岗
佛山综合: 佛山综合
佛山公共: 佛山公共
佛山顺德: 佛山顺德
佛山南海: 佛山南海
东莞新闻综合: 东莞新闻综合
东莞生活咨询: 东莞生活咨询
惠州综合: 惠州综合
惠州都市生活: 惠州都市生活
珠海: 珠海
江门综合: 江门综合
中山综合: 中山综合
香山文化: 香山文化
肇庆新闻综合: 肇庆新闻综合
肇庆生活服务: 肇庆生活服务
揭阳综合: 揭阳综合
揭阳生活: 揭阳生活
潮州综合: 潮州综合
潮州民生: 潮州民生
汕尾新闻综合: 汕尾新闻综合
汕尾文化生活: 汕尾文化生活
湛江新闻综合: 湛江新闻综合
湛江公共: 湛江公共
阳江-1: 阳江-1
阳江-2: 阳江-2
云浮综合: 云浮综合
云浮文旅: 云浮文旅
清远新闻综合: 清远新闻综合
韶关新闻综合: 韶关新闻综合
河源新闻综合: 河源新闻综合
河源公共: 河源公共
梅州综合: 梅州综合
梅州客家生活: 梅州客家生活
睛彩竞技: 睛彩竞技
睛彩篮球: 睛彩篮球
睛彩青少: 睛彩青少
睛彩广场舞: 睛彩广场舞
宜和购物: 宜和购物
中国天气: 中国天气
CCTV-1 综合: CCTV-1 综合
CCTV-2 财经: CCTV-2 财经
CCTV-3 综艺: CCTV-3 综艺
CCTV-4 中文国际: CCTV-4 中文国际
CCTV-4 中文国际欧洲: CCTV-4 中文国际欧洲
CCTV-4 中文国际美洲: CCTV-4 中文国际美洲
CCTV-5+ 体育赛事: CCTV-5+ 体育赛事
CCTV-5 体育: CCTV-5 体育
CCTV-6 电影: CCTV-6 电影
CCTV-7 国防 军事: CCTV-7 国防 军事
CCTV-8 电视剧: CCTV-8 电视剧
CCTV-9 记录: CCTV-9 记录
CCTV-10 科教: CCTV-10 科教
CCTV-11 戏曲: CCTV-11 戏曲
CCTV-12 社会与法: CCTV-12 社会与法
CCTV-13 新闻: CCTV-13 新闻
CCTV-14 少儿: CCTV-14 少儿
CCTV-15 音乐: CCTV-15 音乐
CCTV-16 奥林匹克: CCTV-16 奥林匹克
CCTV-17 农业 农村: CCTV-17 农业 农村
CCTV-卫生健康: CCTV-卫生健康
CCTV-兵器科技: CCTV-兵器科技
CCTV-电视指南: CCTV-电视指南
CCTV-央视足球: CCTV-央视足球
CCTV-央视台球: CCTV-央视台球
CCTV-高尔夫网球: CCTV-高尔夫网球
CCTV-女性时尚: CCTV-女性时尚
CCTV-世界地理: CCTV-世界地理
CCTV-怀旧剧场: CCTV-怀旧剧场
CCTV-风云剧场: CCTV-风云剧场
CCTV-央视文化精品: CCTV-央视文化精品
CCTV-第一剧场: CCTV-第一剧场
CCTV-风云音乐: CCTV-风云音乐
CGTN英语: CGTN英语
CGTN英文记录: CGTN英文记录
CGTN西班牙语: CGTN西班牙语
CGTN法语: CGTN法语
CGTN阿拉伯语: CGTN阿拉伯语
CGTN俄语: CGTN俄语
湖南卫视: 湖南卫视
浙江卫视: 浙江卫视
江苏卫视: 江苏卫视
东方卫视: 东方卫视
安徽卫视: 安徽卫视
北京卫视: 北京卫视
天津卫视: 天津卫视
山东卫视: 山东卫视
江西卫视: 江西卫视
湖北卫视: 湖北卫视
辽宁卫视: 辽宁卫视
黑龙江卫视: 黑龙江卫视
贵州卫视: 贵州卫视
四川卫视: 四川卫视
河南卫视: 河南卫视
云南卫视: 云南卫视
重庆卫视: 重庆卫视
河北卫视: 河北卫视
东南卫视: 东南卫视
广西卫视: 广西卫视
吉林卫视: 吉林卫视
陕西卫视: 陕西卫视
山西卫视: 山西卫视
内蒙古卫视: 内蒙古卫视
青海卫视: 青海卫视
海南卫视: 海南卫视
宁夏卫视: 宁夏卫视
西藏卫视: 西藏卫视
新疆卫视: 新疆卫视
甘肃卫视: 甘肃卫视
兵团卫视: 兵团卫视
茶: 茶
快乐垂钓: 快乐垂钓
求索纪录: 求索纪录
天元围棋: 天元围棋
广东卫视4K: 广东卫视4K
广东4K超高清: 广东4K超高清
广东4K超高清 窄色域 30: 广东4K超高清 窄色域 30
广州南国都市4K: 广州南国都市4K
深圳卫视4K: 深圳卫视4K
CCTV4K-50P: CCTV4K-50P
北京卫视4K-25P: 北京卫视4K-25P
北京卫视4K-50P: 北京卫视4K-50P
卡酷动画: 卡酷动画
金鹰卡通: 金鹰卡通
CETV-1: CETV-1
山东教育: 山东教育
财富天下: 财富天下
厦门卫视: 厦门卫视
优漫卡通: 优漫卡通
三沙卫视: 三沙卫视
吉林延边卫视: 吉林延边卫视
金鹰纪实: 金鹰纪实
CETV2: CETV2
CETV4: CETV4
早期教育: 早期教育
汽摩: 汽摩
老故事: 老故事
国学: 国学
爱电影: 爱电影
经典电影: 经典电影
爱大剧: 爱大剧
热播剧场: 热播剧场
爱综艺: 爱综艺
少儿动画: 少儿动画
魅力时尚: 魅力时尚
SUPER FREE: SUPER FREE
SUPER獎門人: SUPER獎門人
SUPER EYT: SUPER EYT
SUPER識食: SUPER識食
SUPER識嘆: SUPER識嘆
SUPER Music: SUPER Music
SUPER金曲: SUPER金曲
SUPER煲劇: SUPER煲劇
SUPER單元劇: SUPER單元劇
真情SUPER煲: 真情SUPER煲
SUPER Sports: SUPER Sports
myTV SUPER 18台: myTV SUPER 18台
黃金翡翠台: 黃金翡翠台
翡翠台: 翡翠台
TVB Plus: TVB Plus
無綫新聞台: 無綫新聞台
明珠台: 明珠台
千禧經典台: 千禧經典台
亞洲劇台: 亞洲劇台
華語劇台: 華語劇台
黃金華劇台: 黃金華劇台
娛樂新聞台: 娛樂新聞台
戲曲台: 戲曲台
SUPER Kids Channel: SUPER Kids Channel
ZooMoo: ZooMoo
Nickelodeon: Nickelodeon
Nick Jr: Nick Jr
粵語片台: 粵語片台
美亞電影台: 美亞電影台
Thrill: Thrill
天映經典頻道: 天映經典頻道
中國電影頻道: 中國電影頻道
ROCK Action: ROCK Action
PopC: PopC
Action Hollywood Movies: Action Hollywood Movies
Rialto Classic Movies (RCM): Rialto Classic Movies (RCM)
KIX: KIX
TRACE Sport Stars: TRACE Sport Stars
Love Nature HD: Love Nature HD
Love Nature 4K: Love Nature 4K
Global Trekker: Global Trekker
Pet Club TV: Pet Club TV
Globetrotter: Globetrotter
Docsville: Docsville
Pulse Documentaries: Pulse Documentaries
ROCK綜藝娛樂: ROCK綜藝娛樂
AXN: AXN
ROCK Extreme: ROCK Extreme
Animax: Animax
tvN: tvN
無線衛星亞洲台: 無線衛星亞洲台
創世電視: 創世電視
FashionBox: FashionBox
Mezzo Live HD: Mezzo Live HD
中央電視台綜合頻道 (港澳版): 中央電視台綜合頻道 (港澳版)
CGTN (中國環球電視網)記錄頻道: CGTN (中國環球電視網)記錄頻道
CGTN (中國環球電視網)英語頻道: CGTN (中國環球電視網)英語頻道
東方衛視國際頻道: 東方衛視國際頻道
鳳凰衛視中文台: 鳳凰衛視中文台
鳳凰衛視資訊台: 鳳凰衛視資訊台
鳳凰衛視香港台: 鳳凰衛視香港台
中國中央電視台中文國際頻道: 中國中央電視台中文國際頻道
中國中央電視台娛樂頻道: 中國中央電視台娛樂頻道
中國中央電視台戲曲頻道: 中國中央電視台戲曲頻道
雲南瀾湄國際衛視: 雲南瀾湄國際衛視
安徽廣播電視台國際頻道: 安徽廣播電視台國際頻道
北京電視台國際頻道: 北京電視台國際頻道
廣西電視台國際頻道: 廣西電視台國際頻道
福建海峽衛視國際頻道: 福建海峽衛視國際頻道
湖南電視台國際頻道: 湖南電視台國際頻道
江蘇電視台國際頻道: 江蘇電視台國際頻道
廣東廣播電視台大灣區衛視頻道: 廣東廣播電視台大灣區衛視頻道
浙江電視台國際頻道: 浙江電視台國際頻道
深圳衛視國際頻道: 深圳衛視國際頻道
NOW 70s: NOW 70s
NOW 80s: NOW 80s
NOW ROCK: NOW ROCK
NOW 90s00s: NOW 90s00s
Concerto: Concerto
TRACE Urban: TRACE Urban
無線衛星新聞台: 無線衛星新聞台
亞洲新聞台: 亞洲新聞台
半島電視台英語頻道: 半島電視台英語頻道
France 24: France 24
DW: DW
NHK World-Japan: NHK World-Japan
Arirang TV: Arirang TV
NewsWorld: NewsWorld
myTV SUPER直播足球2台: myTV SUPER直播足球2台
myTV SUPER直播足球3台: myTV SUPER直播足球3台
myTV SUPER直播足球4台: myTV SUPER直播足球4台
myTV SUPER直播足球5台: myTV SUPER直播足球5台
myTV SUPER直播足球6台: myTV SUPER直播足球6台
myTV SUPER直播足球7台: myTV SUPER直播足球7台
測試頻道: 測試頻道
TVB生活台: TVB生活台
TVB星河: TVB星河
澳門綜藝: 澳門綜藝
澳視葡文: 澳視葡文
澳門-Macau: 澳門-Macau
澳門體育: 澳門體育
澳門資訊: 澳門資訊
澳視澳門: 澳視澳門
民視第一台: 民視第一台
民視台灣台: 民視台灣台
民視: 民視
大愛電視: 大愛電視
中視: 中視
中視經典台: 中視經典台
華視: 華視
三立綜合台: 三立綜合台
客家電視台: 客家電視台
八大綜藝台: 八大綜藝台
中視菁采台: 中視菁采台
TVBS精采台: TVBS精采台
愛爾達娛樂台: 愛爾達娛樂台
靖天綜合台: 靖天綜合台
靖天日本台: 靖天日本台
新唐人亞太台: 新唐人亞太台
ARIRANG阿里郎頻道: ARIRANG阿里郎頻道
原住民族電視台: 原住民族電視台
東森購物四台: 東森購物四台
LiveABC互動英語頻道: LiveABC互動英語頻道
達文西頻道: 達文西頻道
ELTV生活英語台: ELTV生活英語台
Nick Jr. 兒童頻道: Nick Jr. 兒童頻道
尼克兒童頻道: 尼克兒童頻道
DreamWorks 夢工廠動畫: DreamWorks 夢工廠動畫
靖天卡通台: 靖天卡通台
靖洋卡通Nice Bingo: 靖洋卡通Nice Bingo
MOMO親子台: MOMO親子台
東森購物一台: 東森購物一台
鏡電視新聞台: 鏡電視新聞台
東森新聞台: 東森新聞台
華視新聞: 華視新聞
民視新聞台: 民視新聞台
三立新聞iNEWS: 三立新聞iNEWS
TVBS新聞: TVBS新聞
東森財經新聞台: 東森財經新聞台
中視新聞: 中視新聞
中天新聞台: 中天新聞台
Bloomberg TV: Bloomberg TV
寰宇新聞台: 寰宇新聞台
寰宇新聞台灣台: 寰宇新聞台灣台
SBN全球財經台: SBN全球財經台
TVBS: TVBS
東森購物二台: 東森購物二台
民視綜藝台: 民視綜藝台
豬哥亮歌廳秀: 豬哥亮歌廳秀
靖天育樂台: 靖天育樂台
KLT-靖天國際台: KLT-靖天國際台
Nice TV 靖天歡樂台: Nice TV 靖天歡樂台
靖天資訊台: 靖天資訊台
TVBS歡樂台: TVBS歡樂台
韓國娛樂台 KMTV: 韓國娛樂台 KMTV
ROCK Entertainment: ROCK Entertainment
Lifetime 娛樂頻道: Lifetime 娛樂頻道
電影原聲台CMusic: 電影原聲台CMusic
MTV Live HD 音樂頻道: MTV Live HD 音樂頻道
CLASSICA 古典樂: CLASSICA 古典樂
東森購物三台: 東森購物三台
INULTRA: INULTRA
智林體育台: 智林體育台
時尚運動X: 時尚運動X
車迷TV: 車迷TV
GINX Esports TV: GINX Esports TV
民視旅遊台: 民視旅遊台
滾動力rollor: 滾動力rollor
亞洲旅遊台: 亞洲旅遊台
fun探索娛樂台: fun探索娛樂台
幸福空間居家台: 幸福空間居家台
Love Nature: Love Nature
History 歷史頻道: History 歷史頻道
愛爾達生活旅遊台: 愛爾達生活旅遊台
LUXE TV Channel: LUXE TV Channel
TV5MONDE STYLE HD 生活時尚: TV5MONDE STYLE HD 生活時尚
MagellanTV頻道 (麥哲倫頻道): MagellanTV頻道 (麥哲倫頻道)
公視戲劇: 公視戲劇
民視影劇台: 民視影劇台
HITS頻道: HITS頻道
八大精彩台: 八大精彩台
霹靂布袋戲: 霹靂布袋戲
靖天戲劇台: 靖天戲劇台
靖洋戲劇台: 靖洋戲劇台
CI 罪案偵查頻道: CI 罪案偵查頻道
視納華仁紀實頻道: 視納華仁紀實頻道
影迷數位紀實台: 影迷數位紀實台
金光布袋戲: 金光布袋戲
采昌影劇台: 采昌影劇台
靖天映畫: 靖天映畫
靖天電影台: 靖天電影台
影迷數位電影台: 影迷數位電影台
amc電影台: amc電影台
CinemaWorld: CinemaWorld
My Cinema Europe HD 我的歐洲電影: My Cinema Europe HD 我的歐洲電影
好消息: 好消息
好消息2台: 好消息2台
大愛二台: 大愛二台
人間衛視: 人間衛視
NHK WORLD-JAPAN: NHK WORLD-JAPAN
FRANCE24 英文台: FRANCE24 英文台
半島國際新聞台: 半島國際新聞台
CNBC Asia 財經台: CNBC Asia 財經台
DW德國之聲: DW德國之聲
鳳梨直擊台: 鳳梨直擊台
香蕉直擊台: 香蕉直擊台
芭樂直擊台: 芭樂直擊台
國會頻道1: 國會頻道1
國會頻道2: 國會頻道2
TVBS綜藝台: TVBS綜藝台
TVBS台劇台: TVBS台劇台
經典電影台: 經典電影台
經典卡通台: 經典卡通台
精選動漫台: 精選動漫台
戲劇免費看 1台: 戲劇免費看 1台
市井豪門-FastTV飛速看: 市井豪門-FastTV飛速看
戲說台灣-FastTV飛速看: 戲說台灣-FastTV飛速看
中視經典戲劇-FastTV飛速看: 中視經典戲劇-FastTV飛速看
花系列戲劇-FastTV飛速看: 花系列戲劇-FastTV飛速看
華視好劇-FastTV飛速看: 華視好劇-FastTV飛速看
公視好劇-FastTV飛速看: 公視好劇-FastTV飛速看
客家好劇-FastTV飛速看: 客家好劇-FastTV飛速看
懷舊經典電影-FastTV飛速看: 懷舊經典電影-FastTV飛速看
精選華語電影-FastTV飛速看: 精選華語電影-FastTV飛速看
台灣靈異事件-FastTV飛速看: 台灣靈異事件-FastTV飛速看
新兵日記-FastTV飛速看: 新兵日記-FastTV飛速看
以家人之名-FastTV飛速看: 以家人之名-FastTV飛速看
加油喜事-FastTV飛速看: 加油喜事-FastTV飛速看
去有風的地方-FastTV飛速看: 去有風的地方-FastTV飛速看
多情城市-FastTV飛速看: 多情城市-FastTV飛速看
黃金歲月-FastTV飛速看: 黃金歲月-FastTV飛速看
花千骨-FastTV飛速看: 花千骨-FastTV飛速看
別打擾我種田-FastTV飛速看: 別打擾我種田-FastTV飛速看
5566偶像劇-FastTV飛速看: 5566偶像劇-FastTV飛速看
不敗愛情偶像劇-FastTV飛速看: 不敗愛情偶像劇-FastTV飛速看
國外電影精選-FastTV飛速看: 國外電影精選-FastTV飛速看
日韓電影大賞-FastTV飛速看: 日韓電影大賞-FastTV飛速看
大愛精選-FastTV飛速看: 大愛精選-FastTV飛速看
飛龍在天-FastTV飛速看: 飛龍在天-FastTV飛速看
女士的品格-FastTV飛速看: 女士的品格-FastTV飛速看
台灣傳奇-FastTV飛速看: 台灣傳奇-FastTV飛速看
小資女孩向前衝-FastTV飛速看: 小資女孩向前衝-FastTV飛速看
世間路-FastTV飛速看: 世間路-FastTV飛速看
恐怖電影-FastTV飛速看: 恐怖電影-FastTV飛速看
古裝武俠劇-FastTV飛速看: 古裝武俠劇-FastTV飛速看
以愛為營-FastTV飛速看: 以愛為營-FastTV飛速看
藍色水玲瓏-FastTV飛速看: 藍色水玲瓏-FastTV飛速看
精彩陸劇-FastTV飛速看: 精彩陸劇-FastTV飛速看
包青天-FastTV飛速看: 包青天-FastTV飛速看
007情報員-FastTV飛速看: 007情報員-FastTV飛速看
葉青歌仔戲-FastTV飛速看: 葉青歌仔戲-FastTV飛速看
大兵日記-FastTV飛速看: 大兵日記-FastTV飛速看
親戚不計較(特輯)-FastTV飛速看: 親戚不計較(特輯)-FastTV飛速看
日劇一丁目-FastTV飛速看: 日劇一丁目-FastTV飛速看
武媚娘傳奇-FastTV飛速看: 武媚娘傳奇-FastTV飛速看
女力故事館-FastTV飛速看: 女力故事館-FastTV飛速看
中國傳奇故事-FastTV飛速看: 中國傳奇故事-FastTV飛速看
天才衝衝衝-FastTV飛速看: 天才衝衝衝-FastTV飛速看
一字千金-FastTV飛速看: 一字千金-FastTV飛速看
綜藝大集合-FastTV飛速看: 綜藝大集合-FastTV飛速看
女人我最大-FastTV飛速看: 女人我最大-FastTV飛速看
食尚玩家-FastTV飛速看: 食尚玩家-FastTV飛速看
11點熱吵店-FastTV飛速看: 11點熱吵店-FastTV飛速看
WTO姐妹會-FastTV飛速看: WTO姐妹會-FastTV飛速看
威廉沈歡樂送-FastTV飛速看: 威廉沈歡樂送-FastTV飛速看
全家有智慧-FastTV飛速看: 全家有智慧-FastTV飛速看
民視健康美麗生活-FastTV飛速看: 民視健康美麗生活-FastTV飛速看
姊妹亮起來-FastTV飛速看: 姊妹亮起來-FastTV飛速看
娛樂百分百-FastTV飛速看: 娛樂百分百-FastTV飛速看
超級冰冰Show-FastTV飛速看: 超級冰冰Show-FastTV飛速看
豬哥會社-FastTV飛速看: 豬哥會社-FastTV飛速看
全能歌手-FastTV飛速看: 全能歌手-FastTV飛速看
鬥陣大廟埕-FastTV飛速看: 鬥陣大廟埕-FastTV飛速看
我的成長-FastTV飛速看: 我的成長-FastTV飛速看
健康2.0-FastTV飛速看: 健康2.0-FastTV飛速看
輕鬆看法律-FastTV飛速看: 輕鬆看法律-FastTV飛速看
TVBS看板人物-FastTV飛速看: TVBS看板人物-FastTV飛速看
野蠻遊戲：We Play -FastTV飛速看: 野蠻遊戲：We Play -FastTV飛速看
最愛韓星-FastTV飛速看: 最愛韓星-FastTV飛速看
廚神明星秀-FastTV飛速看: 廚神明星秀-FastTV飛速看
浩克慢遊-FastTV飛速看: 浩克慢遊-FastTV飛速看
環遊世界800天 -FastTV飛速看: 環遊世界800天 -FastTV飛速看
綜藝新時代-FastTV飛速看: 綜藝新時代-FastTV飛速看
幸福保衛戰-FastTV飛速看: 幸福保衛戰-FastTV飛速看
同學！搞什麼鬼-FastTV飛速看: 同學！搞什麼鬼-FastTV飛速看
爸媽囧很大-FastTV飛速看: 爸媽囧很大-FastTV飛速看
醫學大聯盟-FastTV飛速看: 醫學大聯盟-FastTV飛速看
GoGoTaiwan-FastTV飛速看: GoGoTaiwan-FastTV飛速看
2025雙北世壯運-FastTV飛速看: 2025雙北世壯運-FastTV飛速看
一起追韓星-FastTV飛速看: 一起追韓星-FastTV飛速看
韓流美食料理秀-FastTV飛速看: 韓流美食料理秀-FastTV飛速看
綜藝大贏家-FastTV飛速看: 綜藝大贏家-FastTV飛速看
台灣No.1棒球精選-FastTV飛速看: 台灣No.1棒球精選-FastTV飛速看
HahaTai 哈哈台-FastTV飛速看: HahaTai 哈哈台-FastTV飛速看
霹靂布袋戲-FastTV飛速看: 霹靂布袋戲-FastTV飛速看
金光布袋戲-FastTV飛速看: 金光布袋戲-FastTV飛速看
超人力霸王《TV版》FastTV飛速看: 超人力霸王《TV版》FastTV飛速看
超人力霸王《劇場版》FastTV飛速看: 超人力霸王《劇場版》FastTV飛速看
哆啦A夢-FastTV飛速看: 哆啦A夢-FastTV飛速看
經典卡通-FastTV飛速看: 經典卡通-FastTV飛速看
免費精選動畫-FastTV飛速看: 免費精選動畫-FastTV飛速看
經典迪士尼-FastTV飛速看: 經典迪士尼-FastTV飛速看
FOOD超人-FastTV飛速看: FOOD超人-FastTV飛速看
小兒子-FastTV飛速看: 小兒子-FastTV飛速看
親子一起看-FastTV飛速看: 親子一起看-FastTV飛速看
怪獸之王-FastTV飛速看: 怪獸之王-FastTV飛速看
東離劍遊紀-FastTV飛速看: 東離劍遊紀-FastTV飛速看
HakkaTV: HakkaTV
TVBS新聞台: TVBS新聞台
東森財經新聞: 東森財經新聞
非凡新聞台: 非凡新聞台
GOOD TV: GOOD TV
非凡商業台: 非凡商業台
寰宇財經台: 寰宇財經台
東森購物1台: 東森購物1台
東森購物2台: 東森購物2台
中視新聞台: 中視新聞台
台視財經台: 台視財經台
CLASSICA: CLASSICA
博斯無限台: 博斯無限台
博斯魅力網: 博斯魅力網
博斯運動一台: 博斯運動一台
博斯網球台: 博斯網球台
GOOD TV 2台: GOOD TV 2台
博斯高球1台: 博斯高球1台
博斯運動二台: 博斯運動二台
SETiNEWS: SETiNEWS
台視新聞台: 台視新聞台
DaVinCi: DaVinCi
KMTV HD: KMTV HD
博斯高球2台: 博斯高球2台
EDGE sport: EDGE sport
龍華卡通台: 龍華卡通台
龍華戲劇台: 龍華戲劇台
寰宇新聞一台: 寰宇新聞一台
靖天資訊: 靖天資訊
FTV戲劇: FTV戲劇
FTV旅遊: FTV旅遊
FTV綜藝: FTV綜藝
龍華偶像台: 龍華偶像台
龍華日韓台: 龍華日韓台
CNEX Doc: CNEX Doc
靖天映畫台: 靖天映畫台
Nice Bingo: Nice Bingo
靖天戲劇: 靖天戲劇
靖天電影: 靖天電影
靖天育樂: 靖天育樂
中天亞洲台: 中天亞洲台
采昌影劇: 采昌影劇
愛爾達娛樂: 愛爾達娛樂
Nice TV: Nice TV
靖天國際台: 靖天國際台
TRACEUrban: TRACEUrban
Mezzo Live: Mezzo Live
TRACEsport: TRACEsport
LiTV民視: LiTV民視
LiTV 民視台灣台: LiTV 民視台灣台
LiTV 華視: LiTV 華視
LiTV華視新聞: LiTV華視新聞
博斯無限2台: 博斯無限2台
LiTV中視: LiTV中視
LiTV民視第一台: LiTV民視第一台
LiTV台視: LiTV台視
龍華電影台: 龍華電影台
ELTV英語學習台: ELTV英語學習台
國會頻道1台: 國會頻道1台
國會頻道2台: 國會頻道2台
第1商業: 第1商業
龍華經典台: 龍華經典台
GINX: GINX
LiTV T歡樂台: LiTV T歡樂台
ARIRANG TV: ARIRANG TV
Smart知識台: Smart知識台
台灣戲劇台: 台灣戲劇台
寵物頻道: 寵物頻道
Focus歡樂綜合台: Focus歡樂綜合台
Focus風采戲劇台: Focus風采戲劇台
黃金八點檔: 黃金八點檔
倪珍播新聞: 倪珍播新聞
龍華洋片台: 龍華洋片台
MCE 我的歐洲電影: MCE 我的歐洲電影
DayStar: DayStar
